11111111111
10000000001
10000000001
100C0P0E001
11111111111